F 0,0,225
C 0,0,225



NO ./textures/SCORP11.png
WE ./textures/beamskin3.png 
EA ./textures/beamskin3.png          
SO textures/beamskin.png 




11111111111111111111111111111
10000000000000000011100000001
10000000000000000001000000001
10000000000001000001000000001
10000000000001000000000000001
10000000000011100000000001111
10000000000001000000000000001
10000000000011100000000001111
10000000000000000011100000001
10000000000000000001000000001
10000000000001000001000000001
10000000000001000000000000001
10000000000011100000000001111
10000000000001000000000000001
10000000000011100000000001111
10000000000000000011100000001
10000000000000000001000000001
10000000000001000001000000001
10000000000001000000000000001
10000000000011100000000001111
10000000000001000000000000001
10000000000011100000000001111
10000000000000000011100000001
10000000000000000001000000001
10000000000001000001000000001
100000000W0001000000000000001
10000000000011100000000001111
10000000000001000000000000001
10000000000011100000000001111
10000000000000000011100000001
10000000000000000001000000001
10000000000001000001000000001
10000000000001000000000000001
10000000000011100000000001111
10000000000001000000000000001
10000000000011100000000001111
11111111111111111111111111111
