NO ./textures/bricks.png
WE           ./textures/planks.png 
EA    ./textures/PSTON2good.png          
SO./textures/scifiwall_1.png                         

F 220,100,0             
C     119,255,51


			111111111111111111111111111111111111111111111111111111111111111111111
        111111000000000000000001110000000000000000000000000000000000000000001111
      11100000000000000000100000000000000000000000000000000000000000000000011111
	1111111000000000000100000100000000000000000000000000000000000000000000000001
11111110000000000001000000000000000000000000000000000000000000000000011111111111
1000000000001110000000000000000000000000000000000000000000000000001111
1000000N00000100000000000000000000000000000000000000000000000000000001		
1000000000001110000000000000000000000000000000000000000000000000001111
1000000000000000001110000000000000000000000000000000000000000000000001
1000000000000000000100000000000000000000000000000000000000000000000001
1000000000000100000100000000000000000000000000000000000000000000000001
1000000000000000000100000000000000000000000000000000000000000000000001
1000000000000100000100000000000000000000000000000000000000000000000001
1000000000000000000100000000000000000000000000000000000000000000000001
1000000000000100000100000000000000000000000000000000000000000000000001
1000000000000000000100000000000000000000000000000000000000000000000001
1000000000000100000100000000000000000000000000000000000000000000000001
1000000000000000000100000000000000000000000000000000000000000000000001				
1000000000000100000100000000000000000000000000000000000000000000000001
1000000000000000000100000000000000000000000000000000000000000000000001
1000000000000100000100000000000000000000000000000000000000000000000001
1000000000000000000100000000000000000000000000000000000000000000000001
1000000000000100000100000000000000000000000000000000000000000000000001
11000000000000000001000000000000000000000000000000000000000000000000011
111000000000000100000100000000000000000000000000000000000000000000000011
111100000000000000000100000000000000000000000000000000000000000000000011      
111000000000000100000100000000000000000000000000000000000000000000000111
1000000000000000000100000000000000000000000000000000000000000000000001
1000000000000100000100000000000000000000000000000000000000000000000001
1000000000000000000100000000000000000000000000000000000000000000000001
1000000000000100000100000000000000000000000000000000000000000000000001
1000000000000000000100000000000000000000000000000000000000000000000001
1000000000000100000100000000000000000000000000000000000000000000000001
1000000000000000000100000000000000000000000000000000000000000000000001
1000000000000100000100000000000000000000000000000000000000000000000001
1000000000000000000100000000000000000000000000000000000000000000000001
1000000000000100000100000000000000000000000000000000000000000000000001
1000000000000000000100000000000000000000000000000000000000000000000001
1000000000000100000100000000000000000000000000000000000000000000000001
1000000000000000000100000000000000000000000000000000000000000000000001
1000000000000100000100000000000000000000000000000000000000000000000001
1000000000000000000100000000000000000000000000000000000000000000000001
1000000000000100000100000000000000000000000000000000000000000000000001
1000000000000000000100000000000000000000000000000000000000000000000001
1000000000000100000100000000000000000000000000000000000000000000000001
1000000000000000000100000000000000000000000000000000000000000000000001
1000000000000100000100000000000000000000000000000000000000000000000001
1000000000000000000100000000000000000000000000000000000000000000000001
1000000000000100000100000000000000000000000000000000000000000000000001
1000000000000000000100000000000000000000000000000000000000000000000001
1000000000000100000100000000000000000000000000000000000000000000000001
1000000000000000000100000000000000000000000000000000000000000000000001
1000000000000100000100000000000000000000000000000000000000000000000001
1000000000000000000100000000000000000000000000000000000000000000000001
1000000000000100000100000000000000000000000000000000000000000000000001
1111111111111111111111111111111111111111111111111111111111111111111111				
111111111111111111111111111111111111111111111111111111111111111111111
1100000000000000000000000000000000011111111111111111111       
1111111111111111111111111111111111111111111111111111111111111111
