NO ./textures/bricks.png
WE           ./textures/planks.png 
EA    ./textures/wall512.png          
SO./textures/planks128.png                         

F 220,100,0             
C     225,30,654



 1        111111111111111111111111111111111111111111111111111111111111111111111
        111111000000000000000001110000000000000000000000000000000000000000000000001
      11100000000000000000100000000000000000000000000000000000000000000000001
1111111110000N0000000100000100000000000000000000000000000000000000000000000001
1111111000000000000100000000000000000000000000000000000000000000000001100001
1000000000001110000000000000000000000000000000000000000000000000001111
1000000000000100000000000000000000000000000000000000000000000000000001
1000000000001110000000000000000000000000000000000000000000000000001111
1000000000000000001110000000000000000000000000000000000000000000000001
1000000000000000000100000000000000000000000000000000000000000000000001
1000000000000100000100000000000000000000000000000000000000000000000001
1000000000000000000100000000000000000000000000000000000000000000000001
1000000000000100000100000000000000000000000000000000000000000000000001
1000000000000000000100000000000000000000000000000000000000000000000001
1000000000000100000100000000000000000000000000000000000000000000000001
1000000000000000000100000000000000000000000000000000000000000000000001
1000000000000100000100000000000000000000000000000000000000000000000001
1000000000000000000100000000000000000000000000000000000000000000000001
1000000000000100000100000000000000000000000000000000000000000000000001
1000000000000000000100000000000000000000000000000000000000000000000001
1000000000000100000100000000000000000000000000000000000000000000000001
1000000000000000000100000000000000000000000000000000000000000000000001
1000000000000100000100000000000000000000000000000000000000000000000001
1000000000000000000100000000000000000000000000000000000000000000000001
1 1000000000000100000100000000000000000000000000000000000000000000000001
 11100000000000000000100000000000000000000000000000000000000000000000001
111000000000000100000100000000000000000000000000000000000000000000000001
1000000000000000000100000000000000000000000000000000000000000000000001
1000000000000100000100000000000000000000000000000000000000000000000001
1000000000000000000100000000000000000000000000000000000000000000000001
1000000000000100000100000000000000000000000000000000000000000000000001
1000000000000000000100000000000000000000000000000000000000000000000001
1000000000000100000100000000000000000000000000000000000000000000000001
1000000000000000000100000000000000000000000000000000000000000000000001
1000000000000100000100000000000000000000000000000000000000000000000001
1000000000000000000100000000000000000000000000000000000000000000000001
1000000000000100000100000000000000000000000000000000000000000000000001
1000000000000000000100000000000000000000000000000000000000000000000001
1000000000000100000100000000000000000000000000000000000000000000000001
1000000000000000000100000000000000000000000000000000000000000000000001
1000000000000100000100000000000000000000000000000000000000000000000001
1000000000000000000100000000000000000000000000000000000000000000000001
1000000000000100000100000000000000000000000000000000000000000000000001
1000000000000000000100000000000000000000000000000000000000000000000001
1000000000000100000100000000000000000000000000000000000000000000000001
1000000000000000000100000000000000000000000000000000000000000000000001
1000000000000100000100000000000000000000000000000000000000000000000001
1000000000000000000100000000000000000000000000000000000000000000000001
1000000000000100000100000000000000000000000000000000000000000000000001
1000000000000000000100000000000000000000000000000000000000000000000001
1000000000000100000100000000000000000000000000000000000000000000000001
1000000000000000000100000000000000000000000000000000000000000000000001
1000000000000100000100000000000000000000000000000000000000000000000001
1000000000000000000100000000000000000000000000000000000000000000000001
1000000000000100000100000000000000000000000000000000000000000000000001
1111111111111111111111111111111111111111111111111111111111111111111111
111111111111111111111111111111111111111111111111111111111111111111111
10000000000000000000000000000000000111                        
111111111111111111111111111111111111               1111111111111
