F 220,100,800
C 225,30,56

NO ./textures/bricks.png
WE ./textures/planks.png
EA ./textures/wall512.png
SO ./textures/planks128.png

                 1111111111111111111111111111111111111111111       
1111111111111111100000000000001111111111111111
1000000000000000000000000000000000000000000001111111
10000000000000000000000000001000000000000000000000001111111                 
1000000000000000000000000001W10000000000000000000011101                     
1000000000000000000000000000100000000000000000000001111                 
1111111111111111111111111111111111111111111111111111111111
                    