F 0,0,0
C 0,100,255

NO ./textures/bricks.png
WE ./textures/planks.png
EA ./textures/wall512.png
SO ./textures/planks128.png

                 1111111111111111111111111111111111111111111       
1111111111111111100000000000001111111111111111
1000000000000000000000000000000000000000000001111111
1000000000000000000000001111111111100000000000000001 1111111                 
10000000000000000000000000000000000000000000000000000N1 111                    
1000000000000000000000000111111111111000000000000000000111                
1111111111111111111111111111111111111111111111111111111111
                    