F 0,0,0
C 0,3,5

NO ./textures/bricks.png
WE ./textures/planks.png
EA ./textures/wall512.png
SO ./textures/planks128.png

                 1111111111111111111111111111111111111111111       
1111111111111111100000000000001111111111111111
1000000000000000000000000000000000000000000001111111
10000000000000000000000011111111111000000000000000001111 11                 
10000000000000000000000000000W000000000000000000001110101                    
10000000000000000000000001111111111110000000000000000011111                
1111111111111111111111111111111111111111111111111111111111
                    