F 220,100,800
C 225,30,56

NO ./textures/bricks.png
WE ./textures/planks.png
EA ./textures/wall512.png
SO ./textures/planks128.png

                11111111111111111111111111111111111111111111
1111111111111111100000000000001111111111111111
10000000000000000000000000000000000000000000011111111
10000N000000000000000000000000000000000000000000000011111111
100000000000000000000000000000000000000000000000000000000011
100000000000000000000000000000000000000000000000000000000011
111111111111111111111111111111111111111111111111111111111111
