F       220,100,0
C                225,30,56

NO ./textures/Nyellowmossy.png
SO ./textures/Spurplestone.png   
EA ./textures/Egreystone.png          
WE ./textures/Wcobblestone.png 


111111      11
111111      101
110001      1S1							
110011       1
1 11 1       11