11111111111111111111111111111
10000000000000000011100000001
10000000000000000001000000001
10000N00000001000001000000001
10000000000001000000000000001
1000000000001110000000000111
11111111111111111111111111111
