11111111111111111111111111111
10000000000000000011100000001
10000000000000000001000000001
10000N00000001000001000000001
10000000000001000000000000001
10000000000011100000000001111
11111111111111111111111111111
