F 220,100,0
C 225,30,56

NO ./textures/bricks.png
WE ./textures/planks.png
EA ./textures/wall512.png
SO ./textures/planks128.png


11111111
1011
11N11111
1111
1111
