F       220,100,800
C                225,30,56

NO              ./textures/bricks.png
WE ./textures/planks.png
EA ./textures/wall512.png
SO ./textures/planks128.png



        11111
        1S001   
        11001                     
        11111









  

   
    




