F 220,100,0
C 225,30,56

NO ./textures/bricks.png
WE ./textures/planks.png
EA ./textures/wall512.png
SO ./textures/planks128.png


1111111111   1111111111111111
1000000001   1000011100000001
10000000011111000001000000001
10000N00000001000001000000001
10000000000001000000000000001
10000000000011100000000001111
11111111111111111111111111111
