NO ./textures/SCORP11.png
WE ./textures/beamskin3.png 
EA ./textures/beamskin3.png          
SO ./textures/beamskin.png                         

C 120,160,225
F                          120,60,0           

11111111111111111111111111111111111111111111111111111111111111111111111
111111000000000000000001110000000000000000000000000000000000000001111
111000000000000000001000000000000000000000000000000000000000000000011
111100000000000010000010000000000000000000000000000000000000000000001
1111100000000000010000000000000000000000000000000000000000000001111111
1000000000001110000000000000000000000000000000000000000000000000001111
1000000000000100000000000000000000000000000000000000000000000000000001
1000000000001110000000000000000000000000000000000000000000000000001111
10000000N0000000001110000000000000000000000000000000000000000000000001
1000000000000000000100000000000000000000000000000000000000000000000001
1000000000000100000100000000000000000000000000000000000000000000000001
1000000000000100000100000000000000000000000000000000000000000000000001
1000000000000100000100000000000000000000000000000000000000000000000001
1000000000000100000100000000000000000000000000000000000000000000000001
1000000000000100000100000000000000000000000000000000000000000000000001
1000000000000000000100000000000000000000000000000000000000000000000001
1000000000000000000100000000000000000000000000000000000000000000000001
1000000000000000000100000000000000000000000000000000000000000000000001
1000000000000100000100000000000000000000000000000000000000000000000001
1000000000000100000100000000000000000000000000000000000000000000000001
1000000000000100000100000000000000000000000000000000000000000000000001
1000000000000100000100000000000000000000000000000000000000000000000001
1000000000000100000100000000000000000000000000000000000000000000000001
11000000000001000001000000000000000000000000000000000000000000000000011
111000000000000100000100000000000000000000000000000000000000000000000011
10000000000000000001000000000000000000000000000000000000000000000000011
1000000000000000000100000000000000000000000000000000000000000000000001
1000000000000100000100000000000000000000000000000000000000000000000001
1000000000000000000100000000000000000000000000000000000000000000000001
1000000000000100000100000000000000000000000000000000000000000000000001
1000000000000000000100000000000000000000000000000000000000000000000001
1000000000000100000100000000000000000000000000000000000000000000000001
1000000000000000000100000000000000000000000000000000000000000000000001
1000000000000100000100000000000000000000000000000000000000000000000001
1000000000000000000100000000000000000000000000000000000000000000000001
1000000000000100000100000000000000000000000000000000000000000000000001
1000000000000000000100000000000000000000000000000000000000000000000001
1000000000000100000100000000000000000000000000000000000000000000000001
1000000000000000000100000000000000000000000000000000000000000000000001
1000000000000100000100000000000000000000000000000000000000000000000001
1000000000000000000100000000000000000000000000000000000000000000000001
1000000000000100000100000000000000000000000000000000000000000000000001
1111111111111111111111111111111111111111111111111111111111111111111111
