

NO ./textures/Nyellowmossy.png
SO ./textures/Spurplestone.png   
EA ./textures/Egreystone.png          
WE ./textures/Wcobblestone.png 


C 60,221,255
F 120,60,0

1111111111111111111
1000000000000000001
1000000000000000001
1000000S00000000001
1000000000000000001
1000000000000000001
1111111111111111111