111111111111111111111111111111111111111111111
110000000000000000000000000000111111111111111
100000000000000000000000000000000000011111111
10000N000000000000000000000000000000011111111
100000000000000000000000000000000000000000011
100000000000000000000000000000000000000000011
111111111111111111111111111111111111111111111
