F 220,100,800
C 225,30,56

NO ./textures/bricks.png
WE ./textures/planks.png
EA ./textures/wall512.png
SO ./textures/planks128.png

11111111111111111111111111111
10000000000000000011100000001
100000N0000000000001000000001
10000000000011100000000001111
11111111111111111111111111111
