
F 44,44,44
C 2,22,222

NO ./textures/Nyellowmossy.png
SO ./textures/Spurplestone.png   
EA ./textures/Egreystone.png          
WE ./textures/Wcobblestone.png 

1111111111111111111
1100000000000000001
1000000000000000001
10000000N0000000001
1000000000000000001
1000000000000000001
1111111111111111111