NO ./textures/SCORP11.png
WE ./textures/beamskin3.png 
EA ./textures/beamskin3.png          
SO ./textures/beamskin.png                         

F 44,44,44
C 2,22,222

11111111111111111111111111111
10000000000000000011100000001
10000000000000000001000000001    111
10000000000011100000000001111    1N1
11111111111111111111111111111    111