F 220,100,0
C225,30,54

NO ./textures/bricks.png
WE ./textures/planks.png
EA ./textures/wall512.png
SO ./textures/planks128.png

                    111111111111111111111111111111111111111111111111111111111111111111111111111111111111111111111111111111
100000000000000000000000000000000000000000000000000000000000000000000000000000000000000000011100000001
100000000000000000000000000000000000000000000000000000000000000000000000000000000000000000001000000001
10000N000000000000000000000000000000000000000000000000000000000000000000000000000000001000001000000001
100000000000000000000000000000000000000000000000000000000000000000000000000000000000000100000000000001
100000000000000000000000000000000000000000000000000000000000000000000000000000000000011100000000001111
111111111111111111111111111111111111111111111111111111111111111111111111111111111111111111111111111111
