NO ./textures/bricks.png
WE           ./textures/planks.png 
EA    ./textures/wall512.png          
SO./textures/scifiwall_1.png                         

C 120,160,225
F 120,60,0   







1111111111111111111111111111111111111111111111111111111111111111111111
1111100000000000000000111000000000000000000000000000000000000000001111
1110000000000000000010000000000000000000000000000000000000000000000011
1111110000N00000001000001000000000000000000000000000000000000000000001
1111111000000000000100000000000000000000000000000000000000000001111111
1000000000001110000000000000000000000000000000000000000000000000001111
1000000000000100000000000000000000000000000000000000000000000000000001
1000000000001110000000000000000000000000000000000000000000000000001111
1000000000000000001110000000000000000000000000000000000000000000000001
1000000000000000000100000000000000000000000000000000000000000000000001
1000000000000100000100000000000000000000000000000000000000000000000001
1000000000000000000100000000000000000000000000000000000000000000000001
1000000000000100000100000000000000000000000000000000000000000000000001
1000000000000000000100000000000000000000000000000000000000000000000001
1000000000000100000100000000000000000000000000000000000000000000000001
1000000000000000000100000000000000000000000000000000000000000000000001
1000000000000100000100000000000000000000000000000000000000000000000001
1000000000000000000100000000000000000000000000000000000000000000000001
1000000000000100000100000000000000000000000000000000000000000000000001
1000000000000000000100000000000000000000000000000000000000000000000001
1000000000000100000100000000000000000000000000000000000000000000000001
1000000000000000000100000000000000000000000000000000000000000000000001
1000000000000100000100000000000000000000000000000000000000000000000001
1100000000000000000100000000000000000000000000000000000000000000000011
1110000000000001000001000000000000000000000000000000000000000000000011
1111000000000000000001000000000000000000000000000000000000000000000011      
1110000000000001000001000000000000000000000000000000000000000000000111
1000000000000000000100000000000000000000000000000000000000000000000001
1000000000000100000100000000000000000000000000000000000000000000000001
1000000000000000000100000000000000000000000000000000000000000000000001
1000000000000100000100000000000000000000000000000000000000000000000001
1000000000000000000100000000000000000000000000000000000000000000000001
1000000000000100000100000000000000000000000000000000000000000000000001
1000000000000000000100000000000000000000000000000000000000000000000001
1000000000000100000100000000000000000000000000000000000000000000000001
1000000000000000000100000000000000000000000000000000000000000000000001
1000000000000100000100000000000000000000000000000000000000000000000001
1000000000000000000100000000000000000000000000000000000000000000000001
1000000000000100000100000000000000000000000000000000000000000000000001
1000000000000000000100000000000000000000000000000000000000000000000001
1000000000000100000100000000000000000000000000000000000000000000000001
1000000000000000000100000000000000000000000000000000000000000000000001
1000000000000100000100000000000000000000000000000000000000000000000001
1000000000000000000100000000000000000000000000000000000000000000000001
1000000000000100000100000000000000000000000000000000000000000000000001
1000000000000000000100000000000000000000000000000000000000000000000001
1000000000000100000100000000000000000000000000000000000000000000000001
1000000000000000000100000000000000000000000000000000000000000000000001
1000000000000100000100000000000000000000000000000000000000000000000001
1000000000000000000100000000000000000000000000000000000000000000000001
1000000000000100000100000000000000000000000000000000000000000000000001
1000000000000000000100000000000000000000000000000000000000000000000001
1000000000000100000100000000000000000000000000000000000000000000000001
1000000000000000000100000000000000000000000000000000000000000000000001
1000000000000100000100000000000000000000000000000000000000000000000001
1000000000000000000100000000000000000000000000000000000000000000000001
1000000000000100000100000000000000000000000000000000000000000000000001
1000000000000000000100000000000000000000000000000000000000000000000001
1000000000000100000100000000000000000000000000000000000000000000000001
1000000000000000000100000000000000000000000000000000000000000000000001
1000000000000100000100000000000000000000000000000000000000000000000001
1000000000000000000100000000000000000000000000000000000000000000000001
1000000000000100000100000000000000000000000000000000000000000000000001
1000000000000000000100000000000000000000000000000000000000000000000001
1000000000000100000100000000000000000000000000000000000000000000000001
1000000000000000000100000000000000000000000000000000000000000000000001
1000000000000100000100000000000000000000000000000000000000000000000001
1000000000000000000100000000000000000000000000000000000000000000000001
1000000000000100000100000000000000000000000000000000000000000000000001
1000000000000000000100000000000000000000000000000000000000000000000001
1000000000000100000100000000000000000000000000000000000000000000000001
1000000000000000000100000000000000000000000000000000000000000000000001
1000000000000100000100000000000000000000000000000000000000000000000001
1000000000000000000100000000000000000000000000000000000000000000000001
1000000000000100000100000000000000000000000000000000000000000000000001
1000000000000000000100000000000000000000000000000000000000000000000001
1000000000000100000100000000000000000000000000000000000000000000000001
1000000000000000000100000000000000000000000000000000000000000000000001
1000000000000100000100000000000000000000000000000000000000000000000001
1000000000000000000100000000000000000000000000000000000000000000000001
1000000000000100000100000000000000000000000000000000000000000000000001
1000000000000000000100000000000000000000000000000000000000000000000001
1000000000000100000100000000000000000000000000000000000000000000000001
1000000000000000000100000000000000000000000000000000000000000000000001
1000000000000100000100000000000000000000000000000000000000000000000001
1000000000000000000100000000000000000000000000000000000000000000000001
1000000000000100000100000000000000000000000000000000000000000000000001
1000000000000000000100000000000000000000000000000000000000000000000001
1000000000000100000100000000000000000000000000000000000000000000000001
1000000000000000000100000000000000000000000000000000000000000000000001
1000000000000100000100000000000000000000000000000000000000000000000001
1000000000000000000100000000000000000000000000000000000000000000000001
1000000000000100000100000000000000000000000000000000000000000000000001
1000000000000000000100000000000000000000000000000000000000000000000001
1000000000000100000100000000000000000000000000000000000000000000000001
1000000000000000000100000000000000000000000000000000000000000000000001
1000000000000100000100000000000000000000000000000000000000000000000001
1000000000000000000100000000000000000000000000000000000000000000000001
1000000000000100000100000000000000000000000000000000000000000000000001
1000000000000000000100000000000000000000000000000000000000000000000001
1000000000000100000100000000000000000000000000000000000000000000000001
1000000000000000000100000000000000000000000000000000000000000000000001
1000000000000100000100000000000000000000000000000000000000000000000001
1000000000000000000100000000000000000000000000000000000000000000000001
1000000000000100000100000000000000000000000000000000000000000000000001
1000000000000000000100000000000000000000000000000000000000000000000001
1000000000000100000100000000000000000000000000000000000000000000000001
1000000000000000000100000000000000000000000000000000000000000000000001
1000000000000100000100000000000000000000000000000000000000000000000001
1000000000000000000100000000000000000000000000000000000000000000000001
1000000000000100000100000000000000000000000000000000000000000000000001
1000000000000000000100000000000000000000000000000000000000000000000001
1000000000000100000100000000000000000000000000000000000000000000000001
1000000000000000000100000000000000000000000000000000000000000000000001
1000000000000100000100000000000000000000000000000000000000000000000001
1000000000000000000100000000000000000000000000000000000000000000000001
1000000000000100000100000000000000000000000000000000000000000000000001
1000000000000000000100000000000000000000000000000000000000000000000001
1000000000000100000100000000000000000000000000000000000000000000000001
1000000000000000000100000000000000000000000000000000000000000000000001
1000000000000100000100000000000000000000000000000000000000000000000001
1000000000000000000100000000000000000000000000000000000000000000000001
1000000000000100000100000000000000000000000000000000000000000000000001
1000000000000000000100000000000000000000000000000000000000000000000001
1000000000000100000100000000000000000000000000000000000000000000000001
1000000000000000000100000000000000000000000000000000000000000000000001
1000000000000100000100000000000000000000000000000000000000000000000001
1000000000000000000100000000000000000000000000000000000000000000000001
1000000000000100000100000000000000000000000000000000000000000000000001
1000000000000000000100000000000000000000000000000000000000000000000001
1000000000000100000100000000000000000000000000000000000000000000000001
1000000000000000000100000000000000000000000000000000000000000000000001
1000000000000100000100000000000000000000000000000000000000000000000001
1000000000000000000100000000000000000000000000000000000000000000000001
1000000000000100000100000000000000000000000000000000000000000000000001
1000000000000000000100000000000000000000000000000000000000000000000001
1000000000000100000100000000000000000000000000000000000000000000000001
1000000000000000000100000000000000000000000000000000000000000000000001
1000000000000100000100000000000000000000000000000000000000000000000001
1000000000000000000100000000000000000000000000000000000000000000000001
1000000000000100000100000000000000000000000000000000000000000000000001
1000000000000000000100000000000000000000000000000000000000000000000001
1000000000000100000100000000000000000000000000000000000000000000000001
1000000000000000000100000000000000000000000000000000000000000000000001
1000000000000100000100000000000000000000000000000000000000000000000001
1000000000000000000100000000000000000000000000000000000000000000000001
1000000000000100000100000000000000000000000000000000000000000000000001
1000000000000000000100000000000000000000000000000000000000000000000001
1000000000000100000100000000000000000000000000000000000000000000000001
1000000000000000000100000000000000000000000000000000000000000000000001
1000000000000100000100000000000000000000000000000000000000000000000001
1000000000000000000100000000000000000000000000000000000000000000000001
1000000000000100000100000000000000000000000000000000000000000000000001
1000000000000000000100000000000000000000000000000000000000000000000001
1000000000000100000100000000000000000000000000000000000000000000000001
1000000000000000000100000000000000000000000000000000000000000000000001
1000000000000100000100000000000000000000000000000000000000000000000001
1000000000000000000100000000000000000000000000000000000000000000000001
1000000000000100000100000000000000000000000000000000000000000000000001
1000000000000000000100000000000000000000000000000000000000000000000001
1000000000000100000100000000000000000000000000000000000000000000000001
1000000000000000000100000000000000000000000000000000000000000000000001
1000000000000100000100000000000000000000000000000000000000000000000001
1000000000000000000100000000000000000000000000000000000000000000000001
1000000000000100000100000000000000000000000000000000000000000000000001
1000000000000000000100000000000000000000000000000000000000000000000001
1000000000000100000100000000000000000000000000000000000000000000000001
1000000000000000000100000000000000000000000000000000000000000000000001
1000000000000100000100000000000000000000000000000000000000000000000001
1000000000000000000100000000000000000000000000000000000000000000000001
1000000000000100000100000000000000000000000000000000000000000000000001
1000000000000000000100000000000000000000000000000000000000000000000001
1000000000000100000100000000000000000000000000000000000000000000000001
1000000000000000000100000000000000000000000000000000000000000000000001
1000000000000100000100000000000000000000000000000000000000000000000001
1000000000000000000100000000000000000000000000000000000000000000000001
1000000000000100000100000000000000000000000000000000000000000000000001
1000000000000000000100000000000000000000000000000000000000000000000001
1000000000000100000100000000000000000000000000000000000000000000000001
1000000000000000000100000000000000000000000000000000000000000000000001
1000000000000100000100000000000000000000000000000000000000000000000001
1000000000000000000100000000000000000000000000000000000000000000000001
1000000000000100000100000000000000000000000000000000000000000000000001
1000000000000000000100000000000000000000000000000000000000000000000001
1000000000000100000100000000000000000000000000000000000000000000000001
1000000000000000000100000000000000000000000000000000000000000000000001
1000000000000100000100000000000000000000000000000000000000000000000001
1000000000000000000100000000000000000000000000000000000000000000000001
1000000000000100000100000000000000000000000000000000000000000000000001
1000000000000000000100000000000000000000000000000000000000000000000001
1000000000000100000100000000000000000000000000000000000000000000000001
1000000000000000000100000000000000000000000000000000000000000000000001
1000000000000100000100000000000000000000000000000000000000000000000001
1000000000000000000100000000000000000000000000000000000000000000000001
1000000000000100000100000000000000000000000000000000000000000000000001
1000000000000000000100000000000000000000000000000000000000000000000001
1000000000000100000100000000000000000000000000000000000000000000000001
1000000000000000000100000000000000000000000000000000000000000000000001
1000000000000100000100000000000000000000000000000000000000000000000001
1000000000000000000100000000000000000000000000000000000000000000000001
1000000000000100000100000000000000000000000000000000000000000000000001
1000000000000000000100000000000000000000000000000000000000000000000001
1000000000000100000100000000000000000000000000000000000000000000000001
1000000000000000000100000000000000000000000000000000000000000000000001
1000000000000100000100000000000000000000000000000000000000000000000001
1000000000000000000100000000000000000000000000000000000000000000000001
1000000000000100000100000000000000000000000000000000000000000000000001
1000000000000000000100000000000000000000000000000000000000000000000001
1000000000000100000100000000000000000000000000000000000000000000000001
1000000000000000000100000000000000000000000000000000000000000000000001
1000000000000100000100000000000000000000000000000000000000000000000001
1000000000000000000100000000000000000000000000000000000000000000000001
1000000000000100000100000000000000000000000000000000000000000000000001
1000000000000000000100000000000000000000000000000000000000000000000001
1000000000000100000100000000000000000000000000000000000000000000000001
1000000000000000000100000000000000000000000000000000000000000000000001
1000000000000100000100000000000000000000000000000000000000000000000001
1000000000000000000100000000000000000000000000000000000000000000000001
1000000000000100000100000000000000000000000000000000000000000000000001
1000000000000000000100000000000000000000000000000000000000000000000001
1000000000000100000100000000000000000000000000000000000000000000000001
1000000000000000000100000000000000000000000000000000000000000000000001
1000000000000100000100000000000000000000000000000000000000000000000001
1000000000000000000100000000000000000000000000000000000000000000000001
1000000000000100000100000000000000000000000000000000000000000000000001
1000000000000000000100000000000000000000000000000000000000000000000001
1000000000000100000100000000000000000000000000000000000000000000000001
1000000000000000000100000000000000000000000000000000000000000000000001
1000000000000100000100000000000000000000000000000000000000000000000001
1000000000000000000100000000000000000000000000000000000000000000000001
1000000000000100000100000000000000000000000000000000000000000000000001
1000000000000000000100000000000000000000000000000000000000000000000001
1000000000000100000100000000000000000000000000000000000000000000000001
1000000000000000000100000000000000000000000000000000000000000000000001
1000000000000100000100000000000000000000000000000000000000000000000001
1000000000000100000100000000000000000000000000000000000000000000000001
1000000000000000000100000000000000000000000000000000000000000000000001
1000000000000100000100000000000000000000000000000000000000000000000001
1000000000000000000100000000000000000000000000000000000000000000000001
1000000000000100000100000000000000000000000000000000000000000000000001
1000000000000000000100000000000000000000000000000000000000000000000001
1000000000000100000100000000000000000000000000000000000000000000000001
1000000000000000000100000000000000000000000000000000000000000000000001
1000000000000100000100000000000000000000000000000000000000000000000001
1000000000000000000100000000000000000000000000000000000000000000000001
1000000000000100000100000000000000000000000000000000000000000000000001
1000000000000000000100000000000000000000000000000000000000000000000001
1000000000000100000100000000000000000000000000000000000000000000000001
1000000000000000000100000000000000000000000000000000000000000000000001
1000000000000100000100000000000000000000000000000000000000000000000001
1000000000000000000100000000000000000000000000000000000000000000000001
1000000000000100000100000000000000000000000000000000000000000000000001
1000000000000000000100000000000000000000000000000000000000000000000001
1000000000000100000100000000000000000000000000000000000000000000000001
1000000000000000000100000000000000000000000000000000000000000000000001
1000000000000100000100000000000000000000000000000000000000000000000001
1000000000000000000100000000000000000000000000000000000000000000000001
1000000000000100000100000000000000000000000000000000000000000000000001
1000000000000000000100000000000000000000000000000000000000000000000001
1000000000000100000100000000000000000000000000000000000000000000000001
1000000000000000000100000000000000000000000000000000000000000000000001
1000000000000100000100000000000000000000000000000000000000000000000001
1000000000000000000100000000000000000000000000000000000000000000000001
1000000000000100000100000000000000000000000000000000000000000000000001
1000000000000000000100000000000000000000000000000000000000000000000001
1000000000000100000100000000000000000000000000000000000000000000000001
1000000000000000000100000000000000000000000000000000000000000000000001
1000000000000100000100000000000000000000000000000000000000000000000001
1000000000000000000100000000000000000000000000000000000000000000000001
1000000000000100000100000000000000000000000000000000000000000000000001
1000000000000000000100000000000000000000000000000000000000000000000001
1000000000000100000100000000000000000000000000000000000000000000000001
1000000000000000000100000000000000000000000000000000000000000000000001
1000000000000100000100000000000000000000000000000000000000000000000001
1000000000000000000100000000000000000000000000000000000000000000000001
1000000000000100000100000000000000000000000000000000000000000000000001
1000000000000000000100000000000000000000000000000000000000000000000001
1000000000000100000100000000000000000000000000000000000000000000000001
1000000000000000000100000000000000000000000000000000000000000000000001
1000000000000100000100000000000000000000000000000000000000000000000001
1000000000000000000100000000000000000000000000000000000000000000000001
1000000000000100000100000000000000000000000000000000000000000000000001
1000000000000000000100000000000000000000000000000000000000000000000001
1000000000000100000100000000000000000000000000000000000000000000000001
1000000000000000000100000000000000000000000000000000000000000000000001
1000000000000100000100000000000000000000000000000000000000000000000001
1000000000000000000100000000000000000000000000000000000000000000000001
1000000000000100000100000000000000000000000000000000000000000000000001
1000000000000000000100000000000000000000000000000000000000000000000001
1000000000000100000100000000000000000000000000000000000000000000000001
1000000000000000000100000000000000000000000000000000000000000000000001
1000000000000100000100000000000000000000000000000000000000000000000001
1000000000000000000100000000000000000000000000000000000000000000000001
1000000000000100000100000000000000000000000000000000000000000000000001
1000000000000000000100000000000000000000000000000000000000000000000001
1000000000000100000100000000000000000000000000000000000000000000000001
1000000000000000000100000000000000000000000000000000000000000000000001
1000000000000100000100000000000000000000000000000000000000000000000001
1000000000000000000100000000000000000000000000000000000000000000000001
1000000000000100000100000000000000000000000000000000000000000000000001
1000000000000000000100000000000000000000000000000000000000000000000001
1000000000000100000100000000000000000000000000000000000000000000000001
1000000000000000000100000000000000000000000000000000000000000000000001
1000000000000100000100000000000000000000000000000000000000000000000001
1000000000000000000100000000000000000000000000000000000000000000000001
1000000000000100000100000000000000000000000000000000000000000000000001
1000000000000000000100000000000000000000000000000000000000000000000001
1000000000000100000100000000000000000000000000000000000000000000000001
1000000000000000000100000000000000000000000000000000000000000000000001
1000000000000100000100000000000000000000000000000000000000000000000001
1000000000000000000100000000000000000000000000000000000000000000000001
1000000000000100000100000000000000000000000000000000000000000000000001
1000000000000000000100000000000000000000000000000000000000000000000001
1000000000000100000100000000000000000000000000000000000000000000000001
1000000000000000000100000000000000000000000000000000000000000000000001
1000000000000100000100000000000000000000000000000000000000000000000001
1000000000000000000100000000000000000000000000000000000000000000000001
1000000000000000000100000000000000000000000000000000000000000000000001
1000000000000000000100000000000000000000000000000000000000000000000001
1111111111111111111111111111111111111111111111111111111111111111111111